  %%%%%
%%%   %
%DAB  %
%%% BD%
%D%%B %
% % D %%
%B CBBD%
%   D  %
%%%%%%%%